border_size=1
usage=map

Re          , Re          , Re          , Re          , Re          , Re          , Re          , Re          , Re          , Re          , Re          , Re          , Re          , Re          , Re          , Re          , Re          , Re          , Re          , Re          , Re          , Re          , Re          , Re          , Re          , Re          , Re          , Re          , Re          , Re          , Re          , Re          , Re          , Re          , Re          , Re          
Re          , Re          , Re          , Re          , Re          , Re          , Re^Vct      , Re          , Re          , Re          , Re          , Re          , Re          , Re          , Re          , Re          , Re          , Re          , Re          , Re          , Re          , Re          , Re          , Re          , Re          , Re          , Re          , Re          , Re          , Re          , Re          , Re          , Re          , Re          , Re          , Re          
Re          , Re          , Re^Vct      , Re          , Re          , Re          , Re          , Re          , Re          , Re          , Re          , Re^Vct      , Re          , Re          , Re          , Re          , Re          , Re          , Re          , Re          , Re          , Re          , Re          , Re          , Re          , Re          , Re          , Re          , Re          , Re          , Re          , Re          , Re          , Re          , Re          , Re          
Re          , Re          , Re          , Re          , Chr         , Chr         , Chr         , Chr         , Chr         , Re          , Re          , Re          , Re          , Re          , Re          , Re          , Re          , Re^Vct      , Re          , Re          , Re          , Re          , Re          , Re          , Re          , Re          , Re          , Re^Vct      , Re          , Re          , Re          , Re          , Re          , Re          , Re          , Re          
Re          , Re          , Re          , Re          , Chr         , 2 Khr       , Chr         , Chr         , Chr         , Re          , Re          , Re          , Re          , Re          , Re          , Re          , Re          , Re          , Re          , Re          , Re          , Re          , Re          , Re          , Re          , Re          , Re          , Re          , Re          , Re          , Re          , Re          , Re          , Re          , Re          , Re          
Re          , Re          , Re          , Re          , Re          , Chr         , Rd          , Chr         , Re          , Re          , Re          , Re^Vct      , Re          , Re^Vct      , Re          , Re          , Re          , Re          , Re          , Re          , Re^Vct      , Re          , Re          , Re          , Re          , Re          , Re          , Re          , Re          , Re          , Re          , Re          , Re          , Re          , Re          , Re          
Re          , Re          , Re          , Re^Vct      , Re          , Re          , Rd          , Re          , Re          , Re          , Re          , Re          , Re          , Re          , Re          , Re          , Re          , Re          , Re          , Re          , Re          , Re          , Re          , Re          , Re          , Re          , Re          , Re          , Re          , Re          , Re          , Re          , Re^Vct      , Re          , Re          , Re          
Re          , Re          , Re          , Re          , Re          , Re          , Rd          , Re          , Re^Vct      , Re          , Re          , Re          , Re          , Re          , Re          , Re          , Re          , Re          , Re          , Re          , Re          , Re          , Re          , Re          , Re          , Re          , Re          , Re          , Re          , Re          , Re          , Re          , Re          , Re          , Re          , Re          
Re          , Re          , Re          , Re^Vct      , Re          , Re          , Rd          , Re          , Re          , Re          , Re          , Re          , Re          , Re          , Re          , Re          , Re          , Re          , Re          , Re          , Re          , Re          , Re          , Re          , Re          , Re          , Re          , Re^Vct      , Re          , Re          , Re          , Re          , Re          , Re          , Re          , Re          
Re          , Re          , Re          , Re          , Re          , Re          , Re          , Rd          , Rd          , Re          , Re          , Re          , Re          , Re^Vct      , Re          , Re          , Re^Vct      , Re          , Re          , Re          , Re          , Re^Vct      , Re          , Re          , Re          , Re          , Re          , Re          , Re          , Re          , Re          , Re          , Re          , Re          , Re          , Re          
Re          , Re          , Re          , Re          , Re          , Re          , Re          , Re          , Re          , Rd          , Rd          , Khr         , Re          , Re          , Re          , Re          , Re          , Re          , Re          , Khr         , Re          , Re          , Re          , Re          , Re          , Re          , Re          , Re          , Re          , Re          , Re          , Re          , Re          , Re          , Re          , Re          
Re          , Re          , Re^Vct      , Re          , Re          , Re          , Re          , Re          , Re          , Re          , Re          , Rd          , Rd          , Re          , Re          , Re          , Re          , Re          , Re          , Re          , Re          , Re          , Re          , Re          , Re          , Re          , Re          , Re          , Re          , Re          , Re          , Re          , Re          , Re          , Re          , Re          
Re          , Re          , Re          , Re          , Re          , Re          , Re          , Re^Vct      , Re          , Re          , Re          , Re          , Re          , Rd          , Ce          , Ce          , Ce          , Re          , Re          , Re          , Re          , Re          , Re          , Re          , Re          , Re          , Re          , Re          , Re^Vct      , Re          , Re          , Re          , Re          , Re          , Re          , Re          
Re          , Re          , Re          , Re          , Re          , Re          , Re          , Re          , Re          , Re          , Re          , Re          , Re          , Re          , Ce          , 1 Ke        , Ce          , Re          , Re          , Re          , Re          , Re          , Re          , Re          , Re          , Re          , Re          , Re          , Re          , Re          , Re          , Re          , Re          , Re          , Re          , Re          
Re          , Re          , Re          , Re          , Re          , Re          , Re          , Re          , Re          , Re          , Re          , Re^Vct      , Re          , Re          , Re          , Ce          , Re          , Re          , Re          , Re          , Re          , Re          , Re^Vct      , Re          , Re          , Re          , Ce          , Re          , Re          , Re          , Re          , Re          , Re          , Re          , Re          , Re          
Re          , Re          , Re          , Re          , Re^Vct      , Re          , Re          , Re          , Re          , Re          , Re          , Re          , Re          , Re          , Re          , Rd          , Re          , Re          , Re          , Re          , Re          , Re          , Re          , Re          , Re          , Ce          , 3 Ke        , Ce          , Re          , Re          , Re          , Re          , Re          , Re          , Re          , Re          
Re          , Re          , Re          , Re          , Re          , Re          , Re          , Re          , Re          , Re          , Re          , Re          , Re          , Re          , Re          , Rd          , Re          , Re          , Re          , Re          , Re          , Re          , Re          , Re          , Re          , Ce          , Rd          , Rd          , Re          , Re^Vct      , Re          , Re          , Re          , Re          , Re          , Re          
Re          , Re          , Re          , Re          , Re          , Re          , Re          , Re          , Re          , Re          , Re          , Khr         , Re          , Re          , Re          , Rd          , Rd          , Re          , Re          , Khr         , Re          , Re          , Re          , Re          , Re^Vct      , Re          , Rd          , Rd          , Re          , Re          , Re          , Re          , Re          , Re          , Re          , Re          
Re          , Re          , Re          , Re          , Re          , Re          , Re          , Re          , Re          , Re          , Re          , Re          , Re          , Re          , Re          , Re          , Rd          , Rd          , Rd          , Re          , Re          , Re          , Rd          , Re          , Rd          , Rd          , Re          , Re          , Re          , Re          , Re          , Re          , Re          , Re          , Re          , Re          
Re          , Re          , Re          , Re          , Re^Vct      , Re          , Re          , Re          , Re          , Re          , Re          , Re          , Re          , Re          , Re          , Re          , Rd          , Re          , Re          , Rd          , Rd          , Rd          , Re          , Rd          , Re          , Re          , Re          , Re          , Re^Vct      , Re          , Re          , Re          , Re          , Re          , Re          , Re          
Re          , Re          , Re          , Re          , Re          , Re          , Re          , Re          , Re          , Re^Vct      , Re          , Re          , Re          , Re          , Re          , Re          , Rd          , Re          , Re          , Re          , Re          , Re          , Re          , Re          , Re          , Re          , Re          , Re          , Re          , Re          , Re          , Re          , Re          , Re          , Re          , Re          
Gg          , Re          , Re          , Re          , Re          , Re          , Re          , Re          , Re          , Re          , Re          , Re          , Re          , Re          , Re          , Re          , Rd          , Re          , Re          , Re          , Re          , Re          , Re          , Re          , Gg^Ve       , Re          , Re          , Re          , Re          , Re          , Re          , Re          , Re          , Re          , Re          , Re          
Gg          , Gg          , Gg          , Re          , Re          , Re          , Gg          , Gg          , Gg          , Re          , Gg          , Gg          , Gg          , Re          , Gg          , Re          , Rd          , Gg          , Gg          , Re          , Gg          , Re          , Re          , Re          , Re          , Re          , Re          , Re          , Re          , Re          , Re          , Re          , Re          , Re          , Re          , Re          
Gg          , Gg          , Gg          , Gg          , Gg          , Gg          , Gg^Vh       , Gg          , Gg          , Gg          , Gg          , Gg          , Gg          , Re          , Gg          , Gg          , Rd          , Gg          , Gg^Ve       , Gg          , Gg          , Gg          , Gg          , Gg          , Gg          , Gg          , Gg          , Re          , Gg          , Re          , Gg          , Re          , Re          , Re          , Gg          , Re          
Gg          , Gg          , Gg          , Gg          , Gg          , Gg          , Gg          , Gg          , Gg          , Gg          , Gg          , Gg          , Gg          , Gg          , Rd          , Rd          , Gg          , Gg          , Gg          , Gg          , Gg          , Gg          , Gg          , Gg          , Gg          , Gg          , Gg          , Gg          , Gg          , Gg          , Gg          , Gg          , Gg          , Gg          , Re          , Gg          
