border_size=1
usage=map

Gg          , Gg          , Gg          , Gg          , Ch          , Ch          , Ch          , Ch          , Ch          , Gs          , Gs          , Gs          , Gs          , Gs          , Gs          , Gs          , Gs          , Gs          , Hh          , Hh          , Hh          , Hh          , Hh          , Hh          , Hh          , Hh          , Hh          , Hh          , Hh          , Hh          , Hh          , Hh          , Hh          
Gg          , Gg          , Gg          , Ch          , Rp^Vhc      , Rr          , Rr          , Rr          , Rp^Vhc      , Ch          , Gs          , Gs          , Gs          , Gs          , Gs          , Gs          , Gs          , Gs          , Gs          , Hh          , Gs          , Hh          , Hh          , Hh          , Hh          , Hh          , Hh          , Mm          , Mm          , Mm          , Mm^Xm       , Mm          , Hh          
Gg          , Gg          , Gg^Ve       , Ch          , Rr          , Ch          , Ch          , Ch          , Rr          , Ch          , Gs          , Gs          , Gs          , Gs          , Gs          , Gs          , Gs          , Gs          , Gs          , Gs          , Gs          , Gs          , Gs          , Hh          , Hh          , Hh          , Hh^Vhh      , Mm          , Mm          , Mm^Xm       , Mm^Xm       , Mm          , Hh          
Gg          , Gg          , Gg          , Ch          , Rr          , Ch          , 2 Kh        , Ch          , Rr          , Ch          , Gs          , Gs          , Gs          , Gs          , Gs          , Gs          , Gs          , Gs          , Gs          , Gs          , Gs          , Gs^Vht      , Gs          , Gs          , Gs          , Hh          , Hh          , Mm          , Mm          , Mm          , Mm          , Mm^Vhh      , Hh          
Gg          , Gg          , Gg          , Ch          , Rr          , Ch          , Ch          , Ch          , Rr          , Ch          , Gs          , Gg^Ve       , Gs          , Gs          , Gs          , Gs          , Gs          , Gs          , Gs          , Gs          , Gs          , Gs          , Gs          , Gs          , Gs          , Gs          , Gs          , Hh          , Hh          , Hh          , Hh          , Mm          , Hh          
Gg          , Gg          , Gg          , Ch          , Ch          , Rp^Vhc      , Rr          , Rp^Vhc      , Ch          , Ch          , Gs          , Gs          , Gs          , Gs          , Gs          , Gs          , Gs          , Gs          , Gs          , Gs          , Gs          , Gs          , Gs          , Gs          , Gs          , Gs          , Gs          , Gs          , Gs          , Hh          , Hh          , Hh          , Hh          
Gg          , Gg          , Gg          , Gg          , Gg          , Ch          , Rr          , Ch          , Gs          , Gs          , Gs          , Gs          , Gs          , Gs          , Gs          , Gs          , Gs^Vht      , Gs          , Gs          , Gs          , Gs          , Gs          , Gs          , Gs          , Gs          , Gs          , Gs          , Gs          , Gs          , Gs          , Gs          , Hh          , Hh          
Gg          , Gg          , Gg          , Gg          , Gg          , Ch          , Rp          , Ch          , Gs          , Gs          , Gs          , Gs          , Gs          , Gs          , Gs          , Gs          , Gs          , Gs          , Gs          , Gs          , Gs          , Gs          , Gs          , Gs          , Gs          , Gs          , Gs          , Gs^Vht      , Gs          , Gs          , Gs          , Gs          , Gs          
Gg          , Gg          , Gg^Ve       , Gg          , Gg          , Gg          , Rp          , Gs          , Gs          , Gs^Vht      , Gs          , Gs          , Gs          , Gs          , Gs          , Gs          , Gs          , Gs          , Gs          , Gs          , Gs^Vht      , Gs          , Gs          , Gs          , Gs          , Gs          , Gs          , Gs          , Gs          , Gs          , Gs          , Gs          , Gs          
Gg          , Gg          , Gg          , Gg          , Gg          , Ch          , Rp          , Ch          , Gs          , Gs          , Gs          , Gs          , Gs          , Gs          , Gs          , Gs          , Gs          , Gs          , Gs          , Gs          , Gs          , Gs          , Gs          , Gs          , Gs          , Gs          , Gs          , Gs          , Gs          , Gs          , Gs          , Gs          , Gs          
Gg          , Gg          , Gg          , Gg          , Gg          , Gg          , Rp          , Gs          , Gs          , Gs          , Gs          , Gs          , Gs          , Gs          , Gs          , Gs          , Gs          , Gs          , Gs          , Gs          , Gs          , Gs          , Gs          , Gs          , Gs          , Gs          , Gs          , Gs          , Gs          , Gs          , Gs          , Gs          , Gs          
Gg          , Gg          , Gg          , Gg          , Gg^Ve       , Gg          , Gs          , Gs          , Gs          , Gs          , Gs^Vht      , Gs          , Gs          , Gs          , Gs          , Gs^Vht      , Gs          , Gs          , Gs          , Gs          , Gs          , Gs          , Gs          , Gs          , Gs          , Gs          , Gs          , Gs          , Gs          , Gs          , Gs          , Gs          , Gs          
Gg          , Gg          , Gg          , Gg          , Gg          , Gg          , Rd          , Gs          , Gs          , Gs          , Gs          , Gs          , Gs          , Gs          , Gs          , Gs          , Gs          , Gs          , Gs          , Gs          , Gs          , Gs          , Gs          , Gs          , Gs          , Gs          , Gs          , Gs          , Gs          , Gs          , Gs          , Gs          , Gs          
Gg          , Gg          , Re          , Gg          , Gg          , Gg          , Rd          , Rd          , Rd          , Gs          , Gs          , Gs          , Gs          , Gs          , Gs          , Gs          , Gs          , Gs          , Gs          , Gs          , Gs          , Gs          , Gs          , Gs^Vht      , Gs          , Gs          , Gs          , Gs          , Gs          , Gs          , Gs          , Gs          , Gs          
Re          , Re          , Re          , Re          , Re          , Gg          , Rd          , Gg          , Gg          , Rd          , Rd          , Gs          , Gs          , Gs          , Gs          , Gs          , Gs          , Gs          , Gs          , Gs          , Gs          , Gs          , Gs          , Gs          , Ce          , Ce          , Gs          , Gs          , Gs          , Gs          , Gs          , Gs          , Gs          
Re          , Re          , Re          , Re          , Re          , Re          , Rd          , Gg          , Re          , Gg          , Gg          , Rd          , Rd          , Gs          , Gs          , Gs          , Gs          , Gs          , Gs          , Gs          , Gs          , Gs          , Gs          , Ce          , 1 Ke        , Ce          , Gs          , Gs          , Gs          , Gs          , Gs          , Gs          , Gs          
Re          , Re          , Re^Vct      , Re          , Re          , Re          , Rd          , Re          , Re          , Re          , Gg          , Gg          , Gg          , Rd          , Rd          , Gs          , Gs          , Gs          , Gs          , Gs          , Gs          , Gs          , Gs          , Ce          , Ce          , Ce          , Gs          , Gs^Vht      , Gs          , Gs          , Gs          , Gs          , Gs          
Re          , Re          , Re          , Re          , Re          , Re          , Rd          , Re          , Re          , Re          , Re          , Re          , Re          , Re          , Re          , Rd          , Rd          , Gs          , Gs          , Gs          , Gs          , Gs^Vht      , Gs          , Gs          , Gs          , Ce          , Gs          , Gs          , Gs          , Gs          , Gs          , Gs          , Gs          
Re          , Re          , Re          , Re          , Rd          , Rd          , Re          , Re          , Re          , Re^Vct      , Re          , Re          , Re          , Re          , Re          , Gg          , Gg          , Rd          , Rd          , Gs          , Gs          , Gs          , Gs          , Gs          , Gs          , Gs          , Gs          , Gs          , Gs          , Gs          , Gs          , Gs          , Gs          
Re          , Re          , Rd          , Rd          , Re          , Re          , Re          , Re          , Re          , Re          , Re          , Re          , Re          , Re          , Re          , Gg          , Gg          , Gg          , Gg          , Rd          , Rd          , Gs          , Gs          , Gs          , Gs          , Gs          , Gs          , Gs          , Gs          , Gs          , Gs          , Gs          , Gs          
